------------------------------------------------------------------------------------------------------------------------------------------------------
------------------------------------------------------------------------------------------------------------------------------------------------------
------------------------------------------------------------------------------------------------------------------------------------------------------
--------------------------------oo--------------------------------------------------------------------------------------------------------------------
-------------------------------------g-g--------------------------------------------------------------------------------------------------------------
----------------------ooor---------%%%%%%%-------------oooo----------R------------------oo--oo--------------------------------------------------------
---------------------%%%%%----------|||||--------------%%%%----------------g----oo---------------------------R-----oo--------------------##-----------
----------------------|||-----------|||||----oo---------||-------------%%%%%%------------------------r-----------------------------------##-----------
----------------------|||-----------|||||---------------||--------------||||-----------------------%%%%%%%%-------------------SSS------####-----------
----------------------|||-----%%%%%-|||||---------SSS---||--------------||||-----SS-----------------||||||-----------------------------####-----------
-------------------%%%%%%%%----|||--|||||---------------||-------%%%----||||-------------SS---------||||||-----%%%%--%%%%------------######1----------
--------------------||||||-----|||--|||||-------------U-||--------|-----||||------------------------||||||------||----||-------------######-----------
--------------------||||||--o--|||--|||||---------------||--------|-----||||-----------------%%%%---||||||------||----||-------------######--------F--
-M-----------%%%%---||||||-%%%-|||--|||||---------------||--------|-----||||------------------||----||||||--ooo-||----||---------r---######--------#--
XXXXXXXXXXX---||----||||||--|--|||--|||||----%%%%-----%%%%%-%%%%%-|-----||||------------------||----||||||--%%%-||----||----XXXXXXXXXXXXXXXXXXXXXXXXXX
XXXXXXXXXXX---||----||||||--|--|||--|||||-----||-------|||---|||--|-----||||------------------||----||||||---|--||----||----XXXXXXXXXXXXXXXXXXXXXXXXXX
