--------------------------------------------------------------------------------------------------------------------------------------------------------
--------------------------------------------------------------------------------------------------------------------------------------------------------
--------------------------------------------------------------------------------------------------------------------------------------------------------
----------oo-------------------------------------------------------ooo----------------------------------------------------------------------------------
-------------------------------------?-----------------------------%%%------------------------------------------------------------------oo--------------
-------------------------ooooooo------------------------------------|-----------------------------------------------------------------------------------
---------SSSS---------SSSS---------------------------SSoo----SS-----|----------------------------------------oo---%%%%--------------------%%%%----------
-----------------------------------SSSS-----------------------------|-------------------------------SSS------SS----||--------------SSS-----||-----------
----------------------------SSSS------------------------------------|----------------------------------------------||------SSS-oo----------||-----------
--------------------------------------------------------------------|---%%%%------oooo-----------------------------||----------------------||-----------
---%%%%------%%%%%-----------------------------%%%%%%----SS-----SS--|----||--------------%%%%%%-----------------SS-||%%%%%-----SS----------||-----------
----||--------|||-------------------------SSS---||||---------------%%%%%%||---------------||||---------------------||-|||------------------||-----------
----||--------|||--------------%%%%%------------||||----------------||||-||---------------||||---------------------||-|||------------------||---------F-
----||--------|||---------------|||-------------||||----------------||||-||---------------||||---------------------||-|||------------------||---------X-
%%%%||%%%%----|||--%%%%--%%%%---|||-------------||||----------------||||-||%%%%%%%%%-%%%%-||||-%%%%%%----%%%%-----%%%%|||------------------||-XXXXXXXXXX
-||-||-||-----|||---||----||----|||-------------||||----------------||||-||-|||||||---||--||||--||||------||-------||-|||------------------||-XXXXXXXXXX
