-------------------------------------------------------------------------------------------------------------------------------------------------------------
-------------------------------------------------------------------------------------------------------------------------------------------------------------
-------------------------------------------------------------------------------------------------------------------------------------------------------------
-----SSSSSSSSSSSSSSSSSSSSSSSSSSSSSSSSSSSSSSSSSSSSSSSSSSSSSSSSSSSSSSSSSSSSSSSSSSSSSSSSSSSLSSSSSSSSSSSSSSSSSSSSSSSSSSSSSSSSSSSSSSSSSSSSSSSS--------------------
-----------------------------------------------------SS--SSSSSS--SSSS------SSSS------------------------------------------------------------------------------
-----------------------------------------------------SS--SSSSSS--SSSS---g--SSSS------------------------------------------------------------------------------
----------------------------------------oooo-------SS--------SS---S----SS----------oooooo--------------------------------------------------SSS---------------
---------------------------------------------------SS--------SS---S----SS------------------------------------------------------------------------------------
--------------------------------------S-SSSS-U-----SS--------SS---S----SS----------SSSSSS--------------------------------------------------------------------
----------------------------C---------SoS--SoS-----SS----ooooSS---SoU--SC--g-g-----SSSSSS-------------------------------------------------------SSSSSSU------
---------@QQQQ--------#-#-------------SSS--SSS-----SSSS--SSSSSS---SSS--SS--SSSS-----------------------------TT------------------------g##--------------------
--------------------#-#-#-#---#----------------------SS-----------------------------------------------TT----TT-----------SS-----------###--------------------
----------------g-#-#-#-#-#---#-#--------------------SS-----------------------------------------------TT----TT----TT-----SS---------g####--SSS---------------
--M------------g#-#-#-#-#-#-E-#-#--------kk----------------k--g-g------------------------------g-g-g--TT----TT--g-TT-----SS---------#####---------r--------F-
XXXXXXXXXXXXXXXXXXXXXXXXXXXXXXXXXXXXXXXXXXXXXXXXXXXXXXXXXXXXXXXXXXXXXXXXXXXXXXX---XXXXXXXXXXXXXXXXXXXXXXXXXXXXXXXXXXXXX--XX--XXXXXXXXXXXX-------XXXXXXXX--XXX
XXXXXXXXXXXXXXXXXXXXXXXXXXXXXXXXXXXXXXXXXXXXXXXXXXXXXXXXXXXXXXXXXXXXXXXXXXXXXXX---XXXXXXXXXXXXXXXXXXXXXXXXXXXXXXXXXXXXX--XX--XXXXXXXXXXXX-------XXXXXXXX--XXX
