------------------------------------------------------------------------------------------------------------------------------------------------------------------------------------------
------------------------------------------------------------------------------------------------------------------------------------------------------------------------------------------
------------------------------------------------------------------------------------------------------------------------------------------------------------------------------------------
-----SSSSSSSSSSSSSSSSSSSSSSSSSSSSSSSSSSSSSSSSSSSSSSSSSSS----------SSSSSSSSSSSSSSSSSSSSSSSSSSSSSSSSSSSSSSSSSSSSS-------SSSS-----SSSSSSSSSSSSSSSSSSSSSSSSSSS-----SSSSSSSSSSSSSSSSSSSSSSSSSSS
-------------------SSSSSSSSSSSSSSSSSSSSSSSSSSSS----------------------------------------------------------------------------------------------------------------SSSSSSSSSSSSSSSS-----------
-------------------SSSSSSSSSSSSSSSSSSSSSSSCSSSS----------------------------------------------------------------------------------------------------------------SSSSSSSSSSSSSSSS-----------
-------------------SSSSSSSSSSSSSSSSSSSSSSSSSSSS--QQ------------CSS----------------------------------------------------SUS--------------------------------------SSSSSSSSSSSSSSSS-----------
-----------------------------------------------------------------------------TT--------------------------------------------------------------------------------S-------------------TT-----
----------------------------------------------------------SSS--2-------------TT-----------------------------------SSS------SSS---------------------------------S-------------------TT-----
------------------------------------------ggg-----------------2-2------------TT-------S--------------------------------------------------------------------------oooooooooo--------TT-----
---------------------SSSSSS?-SSSSSSSSSSSSSSSSSS--QQ--QQQ---------2---------SCTTSU-------------------------TT----------SSSS-------------------TT-----------------USSSSSSSSSS----#---TT2---F
---------------------SSSSS---SSSSSSSSSSSSSSSSSS------------------------TT----TT----TT---tt-------------#--TT--##-------------------------TT--TT----------#--------------------##---TT---SS
---------------------SSSSS---SSSSSSSSSSSSSSSSSS------------------------TT----TT----TT---tt------------##--TT--##------------------tt-----TT--TT---------##-SSS---------------###---TT---SS
--------------------------oooSSSSSSSSSSSSSSSSSS------------------------TT---kTT---kTT--ktt---------kk-##--TT--##------------------tt----kTT--TT--------###-------------kk---####--kTT---SS
XXXXXXXXXX--XX--X---XXXXXXXXXXXXXXXXXXXXXXXXXXXXXXXXXXXX------XXXXXXXXXXXXXXXXXXXXXXXXXXXXXXXXXXXXXXXXXX--XX--XX------XXXX------XXXXXXXXXXXXXXX--XXXXXXXXX-----XXXXXXXXXXXXXXXXXXXXXXX--XX
XXXXXXXXXX--XX--X---XXXXXXXXXXXXXXXXXXXXXXXXXXXXXXXXXXXX------XXXXXXXXXXXXXXXXXXXXXXXXXXXXXXXXXXXXXXXXXX--XX--XX------XXXX------XXXXXXXXXXXXXXX--XXXXXXXXX-----XXXXXXXXXXXXXXXXXXXXXXX--XX
