------------------------------------------------------------------------------------------------------------------------------------------------------------------------------------------------------------------------------
------------------------------------------------------------------------------------------------------------------------------------------------------------------------------------------------------------------------------
------------------------------------------------------------------------------------------------------------------------------------------------------------------------------------------------------------------------------
------------------------------------------------------------------------------------------------------------------------------------------------------------------------------------------------------------------------------
------------------------------------------------------------------------------------------------------------------------------------------------------------------------------------------------------------------------------
----------------------------------------------------------------------------------------------------------------------------------------------------------------------------------------------------------------y-------------
------------------Q--------------------------------------Q-Q-------------------------1-------------------------------------------------------QQQQ---------------------------------------------------------------##------------
--------------------------------------------------------------------------------------------------oooo----------oooo------------oooo--------------------------------------------------------------------------y###------------
--------------------------------------------------------------------------------------------------------------------------------------------------------------------------------------------------------------####------------
-----------------------------------oo----------------------------------------------------------------------------------------------------------y-------------------------------------------------------------#####------------
------------------?---------------o--o-------------------Q-Q-----------------------QQQQ----------------------TT--------------TT------------QQ?SSQQQ---------------------------------------------------------######2--C--------
--------------TT--------------------------------------------------------------------------------#------------TT--------------TT-------------------------------------------------------#--------------------#######------------
--------------TT--------------------------------------------------------------------------------#------------TT--------------TT-----------------------------TT------------------------#-------------------########--------F---
-M------------TT-------------------------------y-------------y----------------------yy----------#---------y--TT---y------y---TT-----------------------------TT------------------------#----y--y----------#########--------#---
XXXXXXXXXXXXXXXXXXXXXXXXX--XXXXXXXXXXXXXXXXXXXXXXXXXXXXXXXXXXXXXXXXXXXX----XXXXXXXXXXXXXXXXXXXXXXXXXXXXXXXXXXXXXXXXXXXXXXXXXXXXXXXXXXXXXXXXXXX--XXXXXXXXXXXXXXXXXXXXXXX---XXX--XXXXXXXX--XXXXXXXXXXXXXXXXXXXXXXXXXXXXXXXXXXXXX
XXXXXXXXXXXXXXXXXXXXXXXXX--XXXXXXXXXXXXXXXXXXXXXXXXXXXXXXXXXXXXXXXXXXXX----XXXXXXXXXXXXXXXXXXXXXXXXXXXXXXXXXXXXXXXXXXXXXXXXXXXXXXXXXXXXXXXXXXX--XXXXXXXXXXXXXXXXXXXXXXX---XXX--XXXXXXXX--XXXXXXXXXXXXXXXXXXXXXXXXXXXXXXXXXXXXX
