-----------------------------------------------------------------------------------------------------------------------------------------
-----------------------------------------------------------------------------------------------------------------------------------------
-----------------------------------------------------------------------------------------------------------------------------------------
-------------------oo--------------------------------------------------------------------------------------------------------------------
--------------------------g-g------------------------------------------------------------------------------------------------------------
---------ooor---------%%%%%%%-------------oooo----------R------------------oo--oo--------------------------------------------------------
--------%%%%%----------|||||--------------%%%%----------------g----oo---------------------------R-----oo--------------------##-----------
---------|||-----------|||||----oo---SSSS--||-------------%%%%%%----------------------------r-------------------------------##-----------
---------|||-----------|||||---------------||--------------||||-----------------------%%%%%%%%----------------------------####-----------
---------|||-----%%%%%-|||||---------------||--------------||||-----SSS----------------||||||---------------------SSS-----####-----------
------%%%%%%%%----|||--|||||---------------||-------%%%----||||-------------SSS--------||||||-----%%%%--%%%%------------######1----------
-------||||||-----|||--|||||-------------U-||--------|-----||||------------------------||||||------||----||-------------######-----------
-------||||||--o--|||--|||||---------------||--------|-----||||-----------------%%%%---||||||------||----||-------------######--------F--
%%%%---||||||-%%%-|||--|||||---------------||--------|-----||||------------------||----||||||--ooo-||----||---------r---######--------#--
-||----||||||--|--|||--|||||----%%%%-----%%%%%-%%%%%-|-----||||------------------||----||||||--%%%-||----||----XXXXXXXXXXXXXXXXXXXXXXXXXX
-||----||||||--|--|||--|||||-----||-------|||---|||--|-----||||------------------||----||||||---|--||----||----XXXXXXXXXXXXXXXXXXXXXXXXXX
