----------------------------------------------------------------------------------------------------------------------------------------------------------------------------------------------------------------------
----------------------------------------------------------------------------------------------------------------------------------------------------------------------------------------------------------------------
----------------------------------------------------------------------------------------------------------------------------------------------------------------------------------------------------------------------
----------------------------------------------------------------------------------------------------------------------------------------------------------------------------------------------------------------------
---------------------------------------------------------------------------------------------------------------------------------------------------------------------------------------------------------K------------
--------------------------------------------------------------g----------------------------------------------------k--------------------------------------------------------------------------------------------------
------------------SCS-----------------------------------------SSSSS-----SSSSS---------------------------------S---SSSSSSSSS------------US---SS-------------SSS-------------------------------------------##-----------
---------------------------TT-----------------------------------------------------------------------------TT------------------------------------------------------TT------------------------------------###-----------
---------------------------TT----------------------------TT-----------------------TT----------------------TT------------------------------------------------------TT-----------------------------------####-----------
---------------------------XX----------------------TT----TT-----------------------TT----------------------TT-------------------------SS---------------------------TT----------------------------------#####-----------
-----SSS------TT---2---TT----------------TT---SU---TT----XX------------------2----TT-------------tt------SXXS------------------------------SSS---------#---SSS----XX-----TT-------TT----------------TT#####-----------
--------------TT-------TT-------TT----K--TT--------TT----------------------TT-----TT-----TT------tt-----------------------------------------------#-TT-#-----------------TT-----TTTT----TT---------#TT#####-----------
--------------TT-------TT-----TTTT-------TT--------TT---------TT-----tt----TT--TT-TT-----TT------tt-TT--------TT--------------TT--TT-------------##-TT-##----------------TT---TTTTTT----TT--------##TT#####--------F--
--------------TT----k--TT-----TTTT-------TT------k-TT---------TT-----tt----TT--TT-TT---k-TT------tt-TT--------TT--------------TT--TT------------###-TT-##---------k------TT---TTTTTT----TT-------###TT#####--------#--
XXXXXXXXXXXXXXXXXXXXXXXXXXXXXXXXXXXXXXXXXXXXXXXXXXXXXXXXXXXXXXXXXXXXXXXXXXXXXXXXXXXXXXXXXXXXXXXXXXXXXXXXXXXXXXXXXXXXXX------XXXXXXXXXXXX-X-XXXXXXXX-XXXXXXXXXXXXXXXXXXXXXXXXXXXXXXXXXXXXXXXXXXXXXXXXXXXXXXXXXXXXXXXXXX
XXXXXXXXXXXXXXXXXXXXXXXXXXXXXXXXXXXXXXXXXXXXXXXXXXXXXXXXXXXXXXXXXXXXXXXXXXXXXXXXXXXXXXXXXXXXXXXXXXXXXXXXXXXXXXXXXXXXXX------XXXXXXXXXXXX-X-XXXXXXXX-XXXXXXXXXXXXXXXXXXXXXXXXXXXXXXXXXXXXXXXXXXXXXXXXXXXXXXXXXXXXXXXXXX
